11111111111
e0000000101
11111010101
10000010001
10111111111
10000000001
11101111101
10101000001
10111011101
1000001000x
11111111111
