11111111111
e0000000101
10111110101
10000010001
11111011101
10001000101
10111111101
10000000001
10111111111
1000000000x
11111111111
